111111111111111111111111
100000000000P00000000001
111111111111011111111111
10000010100001C1000100C1
101010001011110111010111
1110111010000000000101C1
1C1000101111110111010101
101110100000000101000101
100010111111111101111101
10101010000000C100000001
101010110111111101111111
101000010000001C01000001
101111010111101101101101
1010C1010000100000001C01
101101010111111111011101
1000010000001C0000000101
111111111110111111111111
100000000000E00000000001
111111111111111111111111
