1111111111
1C10000001
1000011101
11110001C1
1C00000001
1011000001
1010010011
100101P001
1E100000C1
1111111111
