11111
10C01
1E001
10001
11111
