11111111
10P000C1
1E111001
10000C01
1!!11111
