11111
10C01
10001
100P1
11111
