11111
10C01
1E001
100P1
11111
