111111111
1000001E1
1100P1111
100000001
111111111
