1111111111
10000000001
1111111111
